{"Id":null,"Data":{"CounterId":"9f9e55d4-b691-4043-a900-539e3ac96cb6","Timestamp":"2014-05-30T07:21:35.0446548Z","PageSpecificMetrics":null,"Data":4.0,"Id":"6f0d15d9-c3a6-49b2-b273-d3491ac25684"},"Metadata":null}