{"Id":null,"Data":{"CounterId":"c5e81f43-44fa-4f25-9c7a-c9b097a48c6c","Timestamp":"2014-05-30T07:52:06.8176295Z","PageSpecificMetrics":null,"Data":4.0,"Id":"97ab99b5-080f-417b-81a2-4fecbae38940"},"Metadata":null}